11 11 11 11 11 11 11 11 11 11 11 11 11 11 11 11 11 11 1 11 11 11 11 11 11 11 1 11 11 11 11 11 11 11 11 11 11 11 11 11 11 11 11 11 11 11 11 11 11 11
11 13 11 11 11 11 11 11 11 11 11 11 11 11 11 11 11 11 1 11 11 11 11 11 11 11 1 11 11 11 11 11 11 11 11 11 11 11 11 11 11 11 11 11 11 11 11 11 11 11
11 11 11 11 11 11 11 11 11 11 11 11 11 11 11 11 11 11 1 11 11 11 11 6 11 11 1 11 11 11 11 5 11 11 11 11 11 11 11 11 11 11 11 11 11 5 11 11 11 11
9 9 9 9 9 9 9 1 1 1 1 11 11 11 11 11 11 11 1 11 11 11 11 11 11 11 1 11 11 11 11 11 11 11 11 11 11 11 11 11 11 11 11 11 11 11 11 11 11 11
11 11 11 11 11 11 11 1 11 11 11 11 11 11 11 11 11 11 9 11 11 11 11 11 11 11 1 11 11 11 11 11 11 11 11 11 11 11 11 11 11 11 11 11 11 11 11 11 11 11
11 11 11 11 11 11 11 1 11 11 11 11 11 11 11 11 11 11 9 11 11 11 11 11 11 11 1 11 11 11 11 11 11 11 11 11 1 1 1 1 1 1 1 1 1 1 1 1 1 1
11 11 11 11 11 11 11 1 11 11 11 8 11 11 11 11 11 11 9 11 11 11 8 11 11 11 1 11 12 11 11 11 11 11 11 11 9 11 11 11 11 11 11 11 11 11 11 11 11 11
11 11 11 6 11 11 11 1 11 11 11 11 11 11 11 11 11 11 9 11 11 11 11 11 11 11 1 11 11 11 11 11 11 11 11 11 9 11 11 11 11 11 11 11 11 11 11 11 11 11
11 11 11 11 11 11 11 1 9 9 9 9 9 9 9 9 9 9 1 1 1 1 1 1 1 1 1 11 11 11 11 11 11 11 11 11 9 11 11 11 12 11 11 11 11 11 11 11 11 11
11 11 11 11 11 11 11 1 11 11 11 11 11 11 11 11 11 11 11 11 11 11 11 11 11 11 1 11 11 11 11 11 11 11 11 9 11 11 11 11 11 11 11 11 1 1 11 11 11 11
9 9 9 9 9 9 9 1 11 11 11 11 11 11 11 11 11 11 11 11 11 11 11 11 11 11 1 11 11 11 11 11 11 11 9 11 11 11 11 11 11 11 11 11 1 11 11 11 11 11
11 11 11 11 11 11 11 1 11 11 11 11 11 11 11 11 11 11 11 11 11 11 11 11 11 11 1 1 1 11 11 11 11 9 11 11 11 11 11 11 11 11 11 11 1 11 11 11 11 11
11 11 11 11 11 11 11 1 11 11 11 5 11 11 11 11 11 11 11 11 11 11 11 11 11 11 11 11 1 1 1 9 9 11 11 11 11 11 11 11 11 11 11 11 1 11 8 11 11 11
11 11 11 5 11 11 11 1 11 11 11 11 11 11 11 11 11 11 11 11 11 11 11 11 11 11 11 11 11 11 1 11 11 11 11 11 11 11 11 11 11 11 11 11 1 11 11 11 11 11
11 11 11 11 11 11 11 1 11 11 11 11 11 11 11 11 11 11 11 11 11 11 11 11 11 11 11 11 11 11 1 11 11 11 11 11 11 11 11 11 11 11 11 11 1 11 11 11 11 11
1 1 1 1 1 1 1 1 1 1 1 1 1 1 1 11 11 11 11 11 11 11 11 11 11 11 11 11 11 11 1 11 11 11 11 11 11 11 11 11 1 1 1 1 1 1 1 1 11 11
11 11 11 11 11 11 11 1 11 11 11 11 11 11 1 11 11 11 11 11 11 11 11 11 11 11 1 1 1 1 1 11 11 11 11 11 11 11 11 11 11 11 11 11 11 11 11 11 11 11
11 11 11 11 11 11 11 1 11 11 11 11 11 11 1 11 11 11 11 11 11 11 11 11 11 11 11 11 11 11 11 11 11 11 11 11 11 11 11 11 11 11 11 11 11 11 11 11 11 11
11 11 11 11 11 11 11 1 11 11 11 11 11 11 1 11 11 11 11 11 11 11 11 11 11 11 11 11 11 11 11 11 11 11 11 11 11 11 11 11 11 11 11 11 11 11 11 11 11 11
11 11 11 11 11 11 11 1 11 11 11 6 11 11 1 11 11 11 11 11 11 11 11 11 11 11 11 11 11 11 11 11 11 11 11 11 11 11 11 11 11 11 8 11 11 11 11 11 11 1
11 11 11 7 11 11 11 1 11 11 11 11 11 11 1 11 11 11 13 11 11 11 11 11 11 11 11 11 11 11 11 11 11 11 11 11 11 11 11 11 11 11 11 11 11 11 11 11 11 1
11 11 11 11 11 11 11 1 11 11 11 11 11 11 1 11 11 11 11 11 11 11 11 11 11 11 11 11 11 11 11 11 11 11 11 11 11 11 11 11 11 11 11 11 11 11 11 11 11 1
11 11 11 11 11 11 11 1 11 11 11 11 11 11 1 1 1 1 1 1 1 1 1 1 10 10 10 10 10 10 1 11 11 11 11 11 11 11 11 11 11 11 11 11 11 11 11 11 11 1
11 11 11 11 11 11 11 1 11 11 11 11 11 11 11 11 11 11 11 11 11 11 11 11 11 11 11 11 11 11 1 11 11 11 11 11 11 11 11 11 11 11 11 11 11 11 11 11 11 1
11 11 11 11 11 11 11 1 11 11 11 11 11 11 11 11 11 11 11 11 11 11 11 11 11 12 11 11 11 11 1 11 11 11 11 11 11 11 11 11 11 11 11 11 11 11 11 11 11 1
11 11 11 5 11 11 11 1 11 11 11 11 11 11 11 11 11 11 11 11 6 11 11 11 11 11 11 11 11 11 1 1 1 1 1 1 1 1 1 1 1 11 11 11 11 11 11 11 11 1
11 11 11 11 11 11 11 1 11 11 11 11 11 11 11 11 11 11 11 11 11 11 11 11 11 11 11 11 11 11 11 11 11 11 11 11 11 11 11 11 1 11 11 11 11 11 11 11 11 1
11 11 11 11 11 11 11 1 11 11 11 11 11 11 11 11 11 11 11 11 11 11 11 11 11 11 11 11 11 11 11 11 11 11 11 11 11 11 11 11 1 11 11 11 11 11 11 11 11 1
10 10 10 10 10 10 10 1 11 11 11 11 11 11 11 11 11 11 11 11 11 11 11 11 11 11 11 11 11 11 11 11 11 11 11 11 6 11 11 11 1 11 11 11 11 6 11 11 11 1
11 11 11 11 11 11 11 11 11 11 11 11 11 11 11 11 11 11 11 11 11 11 11 11 11 11 11 11 11 11 11 11 11 8 11 11 11 11 11 11 1 11 11 11 11 11 11 11 11 1
11 11 11 11 11 11 11 11 11 11 11 11 11 11 11 11 11 11 11 11 11 11 11 11 11 11 11 11 11 11 11 11 11 11 11 11 11 11 11 11 1 1 1 1 1 1 1 1 1 1