21 21 21 21 21 21 21 21 21 21 21 21 21 21 21 21 21 21 1 21 21 21 21 21 21 21 1 21 21 21 21 21 21 21 21 21 21 21 21 21 21 21 21 21 21 21 21 21 21 21
21 21 21 21 21 21 21 21 21 21 21 21 21 21 21 21 21 21 1 21 32 21 21 31 21 21 1 21 21 21 21 21 21 21 21 21 21 21 21 21 21 21 31 21 21 21 21 21 21 21
21 21 21 21 21 21 21 21 21 21 21 21 21 21 21 21 21 21 1 21 21 21 21 21 21 21 1 21 21 21 21 21 21 21 21 21 21 21 21 21 21 21 21 21 21 21 21 21 21 21
24 24 24 24 24 24 24 1 1 1 1 21 21 21 21 21 21 21 1 21 21 21 21 21 21 21 1 21 21 21 21 21 21 21 21 21 21 21 21 21 26 21 21 21 21 21 21 21 21 21
21 21 21 21 21 21 21 1 21 21 21 21 21 21 21 21 21 21 21 21 21 21 21 21 21 21 1 21 21 21 21 21 21 21 21 21 21 21 21 21 21 21 21 21 21 21 21 21 21 21
21 21 21 21 21 21 21 1 21 21 21 21 21 21 21 21 21 21 21 21 21 21 21 21 21 21 1 21 21 21 21 21 21 21 21 21 1 1 1 1 1 1 1 1 1 1 1 1 1 1
21 21 21 31 21 21 21 1 21 21 21 21 21 21 21 21 21 21 21 21 21 21 21 29 21 21 1 21 1 21 21 21 21 21 21 21 21 21 21 21 21 21 21 21 21 21 21 21 21 21
21 21 21 21 21 21 21 1 21 21 21 21 21 21 21 21 21 21 21 21 21 21 21 21 21 21 1 21 21 21 21 21 21 21 21 21 21 21 21 21 21 21 21 21 21 21 21 21 21 21
21 21 21 21 21 21 21 1 21 21 21 21 21 21 21 21 21 21 1 1 1 1 1 1 1 1 1 21 21 21 21 21 21 21 21 21 21 21 21 21 1 21 21 21 21 21 21 21 21 21
24 24 24 24 24 24 24 1 21 21 21 21 21 21 21 21 21 21 21 21 21 21 21 21 21 21 1 21 21 21 21 21 21 21 21 21 21 21 21 21 21 21 21 21 1 1 21 21 21 21
21 21 21 21 21 21 21 1 21 21 21 21 21 21 21 21 21 21 21 21 21 21 21 21 21 21 1 21 21 21 21 21 21 21 21 21 21 21 21 21 21 21 21 21 1 21 21 21 21 21
21 21 21 21 21 21 21 1 21 21 21 21 21 21 21 21 21 21 21 21 21 21 21 21 21 21 1 1 1 21 21 21 21 21 21 21 21 21 21 21 21 21 21 21 1 21 21 21 21 21
21 21 21 21 21 21 21 1 21 21 21 21 21 21 21 21 21 21 21 21 21 21 21 21 21 21 21 21 1 1 1 21 21 21 21 21 21 21 21 21 21 21 21 21 1 21 21 21 21 21
21 21 21 32 21 21 21 1 21 21 21 21 21 21 21 21 21 21 21 21 21 21 21 21 21 21 21 21 21 21 1 21 21 21 21 21 21 21 21 21 21 21 21 21 1 21 21 21 21 21
21 21 21 21 21 21 21 1 21 21 21 21 21 21 21 21 21 21 21 21 21 21 21 21 21 21 21 21 21 21 1 21 21 21 21 21 21 21 21 21 21 21 21 21 1 21 21 21 21 21
1 1 1 1 1 1 1 1 1 1 1 1 1 1 1 21 21 21 21 21 21 21 21 21 21 21 21 21 21 21 1 21 21 21 21 21 21 21 21 21 1 1 1 1 1 1 1 1 21 21
21 21 21 21 21 21 21 1 21 21 21 21 21 21 1 21 21 21 21 21 21 21 21 21 21 21 1 1 1 1 1 21 21 21 21 21 21 21 21 21 21 21 21 21 21 21 21 21 21 21
21 21 21 21 21 21 21 1 21 23 21 21 21 21 1 21 21 21 21 21 21 21 21 21 21 21 21 21 21 21 21 21 21 21 21 21 21 21 21 21 21 21 21 21 21 21 21 21 21 21
21 21 21 21 21 21 21 1 21 21 21 21 21 21 1 21 21 21 21 21 21 21 21 21 21 21 21 21 21 21 21 21 21 21 21 21 21 21 21 21 21 21 21 21 21 21 21 21 21 21
21 21 21 21 21 21 21 1 21 21 21 31 21 21 1 21 21 21 21 21 21 21 21 21 21 21 21 21 21 21 21 21 21 21 21 21 21 21 21 21 21 21 21 21 21 21 21 21 21 1
21 21 21 22 21 21 21 1 21 21 21 21 21 21 1 21 21 21 1 21 21 21 21 21 21 21 21 21 21 21 21 21 21 21 21 21 21 21 21 21 21 21 21 21 21 21 21 21 21 1
21 21 21 21 21 21 21 1 21 21 21 21 21 21 1 21 21 21 21 21 21 21 21 21 21 21 21 23 21 21 21 21 21 21 21 21 21 21 21 21 21 21 21 21 21 21 21 21 21 1
21 21 21 21 21 21 21 1 25 25 25 25 25 25 1 1 1 1 1 1 1 1 1 1 1 1 1 1 1 1 1 21 21 21 21 21 21 21 21 21 21 21 21 21 21 21 21 21 21 1
21 21 21 21 21 21 21 1 21 21 21 21 21 21 21 21 21 21 21 21 21 21 21 21 21 21 21 21 21 21 1 21 21 21 21 21 21 21 21 21 21 21 21 21 21 21 21 21 21 1
21 21 21 32 21 21 21 1 21 21 21 21 21 21 21 21 21 21 21 21 21 21 21 21 21 1 21 21 21 21 1 21 21 21 21 21 21 21 21 21 21 21 21 21 21 21 21 21 21 1
21 21 21 21 21 21 21 1 21 21 21 21 21 21 21 21 21 21 21 21 21 21 21 21 21 21 21 21 21 21 1 1 1 1 1 1 1 1 1 1 1 21 21 21 26 21 21 21 21 1
21 21 21 21 21 21 21 1 21 21 21 21 21 21 21 21 21 21 21 21 21 21 21 21 21 21 21 21 21 21 24 21 21 21 21 21 21 21 21 21 1 21 21 21 21 21 21 21 21 1
21 21 21 21 21 21 21 1 21 21 21 21 21 21 21 21 21 21 21 21 21 21 21 21 21 21 21 21 21 21 24 21 21 21 21 21 21 21 21 21 1 21 21 21 21 21 21 21 21 1
21 31 21 21 21 21 21 1 21 21 21 21 21 21 21 21 21 21 21 21 21 21 21 21 21 21 21 21 21 24 21 21 21 21 21 21 21 21 21 21 1 21 21 21 31 21 21 21 21 1
21 21 21 21 21 21 21 21 21 21 21 21 21 21 21 21 21 21 21 21 21 21 21 21 21 21 21 21 21 21 24 21 21 21 21 21 21 21 21 21 1 21 21 21 21 21 21 21 21 1
21 21 21 21 21 21 21 21 21 21 21 21 21 21 21 21 21 21 21 21 21 21 21 21 21 21 21 21 21 21 24 21 21 21 21 21 21 21 21 21 1 1 1 1 1 1 1 1 1 1