10 10 10 10 10 10 10 10 10 10 10 10 10 10 10 10 10 10 10 10 10 10 10 10 10 10 1 1 1 1 1 1 1 1 1 1 1 1 1 1 1 1 1 1 1 1 1 1 1 1
10 10 10 10 10 10 10 10 10 10 10 10 10 10 10 10 10 10 10 10 10 10 10 10 10 10 10 10 10 10 10 10 10 10 10 10 10 10 10 10 10 10 10 10 10 10 10 10 10 1
10 10 10 10 10 12 10 10 10 10 10 10 10 10 10 10 10 10 11 10 10 10 10 10 10 10 10 10 10 10 10 10 19 10 10 10 10 10 10 10 10 10 10 10 10 10 10 10 10 1
10 10 10 10 10 10 10 10 10 10 10 10 10 10 10 10 10 10 10 10 10 10 10 10 10 10 10 10 10 10 10 10 10 10 10 10 10 10 10 10 10 10 10 10 10 13 10 10 11 1
10 10 10 10 10 10 10 10 10 1 1 1 1 1 1 1 10 10 10 10 10 10 10 10 10 10 1 1 1 1 1 1 1 1 1 10 10 10 10 10 10 10 10 10 10 10 10 10 10 1
14 14 14 14 14 14 1 1 1 1 10 10 10 10 10 1 10 10 10 10 10 10 10 10 1 1 1 10 10 10 10 10 10 10 10 10 10 10 10 10 10 10 10 10 10 10 10 10 10 1
10 10 10 10 10 10 10 10 10 10 10 10 10 10 10 1 1 10 10 10 10 10 10 10 1 10 10 10 10 10 10 10 10 10 10 10 10 10 10 10 10 10 10 10 1 1 1 1 1 1
10 10 10 10 10 10 10 10 10 10 10 10 10 10 10 1 1 14 14 14 14 14 14 14 1 10 10 10 10 10 10 10 10 10 10 10 10 10 10 10 10 10 10 10 1 10 10 10 10 10
10 10 10 10 10 10 10 10 10 10 10 10 10 10 10 1 1 10 10 10 10 10 10 10 1 10 10 10 10 10 10 10 10 10 10 10 10 10 10 10 10 10 10 10 1 10 10 10 10 10
10 11 10 10 13 10 10 10 10 10 10 10 10 10 10 1 1 10 10 10 10 10 10 10 1 10 11 11 10 10 10 10 10 10 10 10 10 10 10 10 10 10 10 10 1 10 20 10 10 10
10 10 10 10 10 10 10 10 10 10 10 10 10 10 10 10 1 10 10 10 10 10 10 1 1 10 10 10 10 10 10 10 10 10 10 10 11 10 10 10 10 10 10 10 1 10 10 10 10 10
10 10 10 10 10 10 10 10 10 10 10 10 10 10 10 10 1 10 10 10 10 10 10 1 10 10 10 10 10 10 10 10 12 10 10 10 10 10 10 10 10 10 10 10 1 10 10 10 10 10
10 10 10 10 10 10 10 10 10 10 10 10 10 10 10 10 1 12 10 13 10 10 10 1 10 10 10 10 10 10 10 10 10 10 10 10 10 10 10 10 10 10 10 10 1 10 10 13 10 10
10 10 10 10 10 10 10 10 10 10 10 10 10 10 10 10 1 10 10 10 10 10 10 1 10 10 10 10 10 10 10 10 10 10 10 10 10 10 10 10 10 10 10 10 1 10 10 10 10 10
10 10 10 18 10 10 10 10 1 1 1 1 10 10 10 10 1 10 10 10 10 10 10 1 10 10 10 10 10 10 10 10 10 10 10 10 10 10 10 10 10 10 10 10 1 10 10 10 10 10
10 10 10 10 10 10 10 10 1 1 10 10 10 10 10 10 1 10 10 10 10 10 10 1 1 1 1 1 1 16 16 16 16 16 16 16 16 16 16 1 1 1 1 1 10 10 10 10 10 10
1 1 1 1 1 1 1 1 1 1 10 10 10 10 10 10 1 10 10 14 10 10 10 1 10 10 10 10 10 10 10 10 10 10 10 10 10 10 10 1 1 10 10 10 10 10 10 10 10 10
10 10 10 10 10 10 10 10 10 10 10 10 10 10 10 10 1 10 10 10 10 10 10 1 10 10 10 10 10 10 10 10 10 10 10 10 10 10 10 1 1 10 10 10 10 10 10 10 10 10
10 10 10 10 10 10 10 10 10 10 10 10 10 10 10 10 1 1 1 1 1 1 1 1 10 10 10 10 10 10 30 10 10 10 10 10 10 10 10 1 1 10 10 10 13 10 10 10 10 10
10 18 10 10 10 10 10 10 10 10 10 10 10 10 10 10 10 10 10 10 1 10 10 10 10 10 10 10 10 10 10 10 10 10 10 10 10 10 10 1 1 10 10 10 10 10 10 10 10 10
10 10 10 10 10 10 10 10 10 10 10 10 10 10 10 10 10 10 10 10 1 10 10 10 10 10 10 10 10 10 10 10 10 10 10 10 10 10 10 1 1 10 10 10 10 10 10 10 10 10
10 11 10 10 10 10 10 10 10 10 10 10 10 10 10 12 10 10 10 10 1 16 16 16 16 16 16 16 16 16 16 16 1 1 1 1 1 1 1 1 1 10 10 10 10 10 10 10 10 10
10 10 10 10 10 10 10 10 10 10 10 10 10 10 10 10 10 10 10 10 1 10 10 10 10 10 10 10 10 10 10 10 10 10 10 10 10 10 10 1 1 10 10 10 10 10 10 10 10 10
10 10 10 10 10 10 10 10 10 10 10 10 10 10 10 10 10 10 10 10 1 10 10 10 10 10 10 10 10 10 10 10 10 10 10 10 10 10 10 1 1 10 10 10 10 10 10 10 10 10
1 1 1 1 1 1 1 1 1 1 1 10 10 10 10 10 10 10 10 10 10 10 10 10 10 10 10 10 10 10 10 10 10 10 10 10 10 10 10 1 1 1 1 10 10 10 10 10 10 10
1 1 1 1 1 1 1 1 1 1 1 10 10 10 10 10 10 10 10 10 10 10 10 10 10 10 10 10 10 10 10 10 10 10 10 10 10 10 10 10 10 10 1 1 1 10 10 10 10 10
10 10 10 10 10 10 10 10 10 1 1 10 10 10 10 10 10 10 10 10 10 10 10 10 10 10 10 10 10 10 10 10 10 10 10 10 10 10 10 10 10 10 10 10 15 10 10 10 10 10
10 10 10 10 10 10 10 10 10 1 1 10 10 10 11 10 10 10 10 10 10 10 10 10 10 10 10 10 10 10 10 10 10 10 10 10 10 10 10 10 10 10 10 10 15 10 10 10 10 10
10 10 10 12 10 10 10 10 10 10 10 10 10 10 10 10 10 10 10 10 10 10 10 10 10 10 10 10 10 10 10 10 10 10 10 10 10 10 10 10 10 10 10 10 15 10 10 10 10 10
10 10 10 10 10 10 10 10 10 10 10 10 10 10 10 10 10 10 10 10 10 10 10 10 10 10 10 10 11 10 11 10 10 10 10 10 10 10 10 10 10 10 10 10 15 10 10 10 10 10
10 10 10 10 10 10 10 10 10 10 10 10 10 10 10 10 10 10 10 10 10 10 10 10 10 10 10 10 10 10 10 10 10 10 10 10 10 10 10 10 10 10 10 10 15 10 10 10 10 10